####################
#p       . . . . .p#
# . .##### . . . . #
# . ## . ## . . . .#
# . ## . ## . . . .#
# . .##### . . . . #
# . . .###########.#
# . . .# . . . . . #
# . . .# . . . . . #
# . . .###########.#
# . .##### . . . . #
# . ## . ## . . . .#
# . ## . ## . . . .#
#p . . . . . . . .p#
####################