####################
#p    . . . . .   p#
#. #. #.##.#. #. # #
#.. . . .. . . . ..#
#.##.##.#..#.##.##.#
# . . . . . . . . .#
#.#.#####..#####.#.#
# . . . . . . . . .#
#.#.#####..#####.#.#
# . . . . . . . . .#
#.##.##.#..#.##.##.#
#.. . . .. . . . ..#
#  #. #.##.#. #. # #
#p  . . . . . .   p#
####################