####################
#p # # # ## # # # p#
# ..#.#.##.#.#.#.. #
# # # # ## # # # # #
#.#.#. ....#.#.#.#.#
# # . # ##   # . # #
#.#.#.#.##.#.#.#.#.#
# # # # ## # . # # #
#.#.#.#.##.#.#.#.#.#
# # .   .. # # . # #
#.#.#.#.##.#.#...#.#
# . . # ## # . ..# #
# #.#.#.##.#.#.#.# #
#p . # # ## # # . p#
####################