####################
#p   . .  . . .   p#
# ###.###.###.### ##
# . . . .. . . . . #
#.###.###.###.###.##
# . . . .. . . . . #
#.###.###.###.###.##
# . . . .. . . . . #
#.###.###.###.###.##
# . . . .. . . . . #
#.###.###.###.###.##
# . . . .. . . . . #
# ###.###.###.### ##
#p   . .  . . .   p#
####################